5,3,7,4,5,4,3,3,5,3
6,2,1,5,2,4,4,4,6,4
9,3,2,8,4,6,6,5,7,5
4,6,5,1,1,9,3,1,2,6
1,2,4,5,7,3,1,3,4,7
2,3,4,3,2,5,6,2,6,1
3,4,6,7,2,1,3,4,4,3
5,6,2,3,5,6,9,8,7,5
1,4,5,6,3,5,6,7,1,2
1,5,6,7,8,8,2,3,2,1